000000000000000000000000000000000000000000000000000000000000000000000000000000000000000000000000000000000000000000000000000000000000000000000000000000000000000000000000000000000
000000000000000000000000000000000000000000000000000000000000000000000000000000000000000000000000000000000000000000000000000000000000000000000000000000000000000000000000000000000
000000000000000000000000000000000000000000000000000000000000000000000000000000000000000000000000000000000000000000000000000000000000000000000000000000000000000000000000000000000
000000000000000000000000000000000000000000000000000000000000000000000000000000000000000000000000000000000000000000000000000000000000000000000000000000000000000000000000000000000
000000000000000000000000000000000000000000000000000000000000000000000000000000000000000000000000000000000000000000000000000000000000000000000000000000000000000000000000000000000
000000000000000000000000000000000000000000000000000000000000000000000000000000000000000000000000000000000000000000000000000000000000000000000000000000000000000000000000000000000
000000000000000000000000000000000000000000000000000000000000000000000000000000000000000000000000000000000000000000000000000000000000000000000000000000000000000000000000000000000
000000000000000000000000000000000000000000000000000000000000000000000000000000000000000000000000000000000000000000000000000000000000000000000000000000000000000000000000000000000
000000000000000000000000000000000000000000000000000000000000000000000066000066600000660000000000000000000000000000000000000000000000000000000000000000000000000000000000000000000
000000000000000000000000000000000000000000000000000000000000000000000066000066600000660000000000000000000000000000000000000000000000000066000000000000000000000000000000000000000
000000000000000000000000000000000000000000000000000000000000000000000011000011100000110000000000000000000000000000000000000000000000000002000000000000000000000000000000000000000
000000000000000000000606060600000000000000000000000000000000000000666000000000000000000000000000000000000000000000000000000000060060000111100000000000000000000000066000000000000
000000000000000000000000000020000000000666000000000000000000000000000000000000000000000000000000000000000000000000000000000000000020000111100000000000000000000000002000000000000
000000000000000000001111111110000000600000006000000000000000000000111000000000000000000000000000000000000000000000000000000000011110000111100000000060000000000000111100000000000
000000000000000000000000000000000001110000011100010000000000000000000000000010000000000000000001000000000000001000000000000000000000000111100000000000000001000000000000000000000
000030000066660000200000000102007000000000010020010000000000000000066600000010000000002000002011000002000000001100666000266600006660000111111020002010206601002000660001200000005
111111111111111111111000001111111111111111111111110000000200111111111111111111111111111111111111111111111111001111111111111111111111111111111111111111111111111111111111111111111
111111111111111111111000001111111111111111111111111666666661111111111111111111111111111111111111111111111111001111111111111111111111111111111111111111111111111111111111111111111
111111111111111111111000001111111111111111111111111111111111111111111111111111111111111111111111111111111111001111111111111111111111111111111111111111111111111111111111111111111
111111111111111111111000001111111111111111111111111111111111111111111111111111111111111111111111111111111111001111111111111111111111111111111111111111111111111111111111111111111
111111111111111111111000001111111111111111111111111111111111111111111111111111111111111111111111111111111111001111111111111111111111111111111111111111111111111111111111111111111
111111111111111111111000001111111111111111111111111111111111111111111111111111111111111111111111111111111111001111111111111111111111111111111111111111111111111111111111111111111
111111111111111111111000001111111111111111111111111111111111111111111111111111111111111111111111111111111111001111111111111111111111111111111111111111111111111111111111111111111
111111111111111111111000001111111111111111111111111111111111111111111111111111111111111111111111111111111111001111111111111111111111111111111111111111111111111111111111111111111
111111111111111111111000001111111111111111111111111111111111111111111111111111111111111111111111111111111111001111111111111111111111111111111111111111111111111111111111111111111
111111111111111111111000001111111111111111111111111111111111111111111111111111111111111111111111111111111111001111111111111111111111111111111111111111111111111111111111111111111
111111111111111111111000001111111111111111111111111111111111111111111111111111111111111111111111111111111111001111111111111111111111111111111111111111111111111111111111111111111
111111111111111111111000001111111111111111111111111111111111111111111111111111111111111111111111111111111111001111111111111111111111111111111111111111111111111111111111111111111
111111111111111111111000001111111111111111111111111111111111111111111111111111111111111111111111111111111111001111111111111111111111111111111111111111111111111111111111111111111
111111111111111111111000001111111111111111111111111111111111111111111111111111111111111111111111111111111111001111111111111111111111111111111111111111111111111111111111111111111
444444444444444444444444444444444444444444444444444444444444444444444444444444444444444444444444444444444444444444444444444444444444444444444444444444444444444444444444444444444