0000000000000000000000000000000
0000000000000000000000000000000
0000000000000001100000000000000
0000000000000011100000000000000
0000000000000111100000000000000
0000000000001101100000000000000
0000000000011001100000000000000
0000000000110001100000000000000
0000000000000001100000000000000
0000000000000001100000000000000
0000000000000001100000000000000
0000000000000001100000000000000
0000000000000001100000000000000
0000000000000001100000000000000
0000000000000001100000000000000
0000000000011111111110000000000
0000000000000000000000000000000
0000000000000000000000000000000

