0000000000000000000000000000000
0000000000000000000000000000000
0000000000001111111100000000000
0000000000011000000110000000000
0000000000011000000010000000000
0000000000011000000000000000000
0000000000011000000000000000000
0000000000011000000000000000000
0000000000001111110000000000000
0000000000011000000000000000000
0000000000011000000000000000000
0000000000011000000000000000000
0000000000011000000000000000000
0000000000011000000010000000000
0000000000011000000110000000000
0000000000001111111100000000000
0000000000000000000000000000000
0000000000000000000000000000000