0000000000000000000000000000000
0000000000000000000000000000000
0000000000000111111100000000000
0000000000001100000110000000000
0000000000011000000010000000000
0000000000010000000010000000000
0000000000000000000110000000000
0000000000000000001100000000000
0000000000000000011000000000000
0000000000000000110000000000000
0000000000000001100000000000000
0000000000000011000000000000000
0000000000000110000000000000000
0000000000001100000000000000000
0000000000011000000000000000000
0000000000011111111110000000000
0000000000000000000000000000000
0000000000000000000000000000000
