00000000000000000000000000000000000000000000000000000000000000
00000000000000000000000000000000000000000000000000000000000000
00000000000000000000000000000000000000000000000000000000000000
00000000000000000000000000000000000000000000000000000000000000
00000000000000000000000000000000000000000000000000000000000000
00000000000000000000000000000000000000000000000000000000000000
00000000000000000000000000000000000000000000000000000000000000
00000000000000000000000000000000000000000000000000000000000000
00000000000000000000000000000000000000000000000000000000000000
00000000000000000000000000000000000000000000000000000000000000
00000000000000000000000000000000000000000000000000000000000000
00000000000000000000000000000000000000000000000000000000000000
00000000000000000000000000000000000000000000000000000000000000
00000000000000000000000000002000000001111000000000000000000000
00001110000000000000111111111100000001111000000000000000000000
00000000000000000000000000000000001111000001110001000000000000
00003000000000000000002000000200000000000000000000000020000005
11111111111111111111111000001111111111111111111111111111111111
00000000000000000000001000001000000000000000000000000000000000
00000000000000000000001000001000000000000000000000000000000000
00000000000000000000001000001000000000000000000000000000000000
00000000000000000000001000001000000000000000000000000000000000
00000000000000000000001000001000000000000000000000000000000000
00000000000000000000001000001000000000000000000000000000000000
00000000000000000000001000001000000000000000000000000000000000
00000000000000000000001000001000000000000000000000000000000000
00000000000000000000001000001000000000000000000000000000000000
00000000000000000000001000001000000000000000000000000000000000
00000000000000000000001000001000000000000000000000000000000000
00000000000000000000001444441000000000000000000000000000000000
00000000000000000000000000000000000000000000000000000000000000
00000000000000000000000000000000000000000000000000000000000000
00000000000000000000000000000000000000000000000000000000000000
00000000000000000000000000000000000000000000000000000000000000
00000000000000000000000000000000000000000000000000000000000000
00000000000000000000000000000000000000000000000000000000000000
