0000000000000000000000000000000
0000000000000000000000000000000
0000000000000000000000000000000
0000000000000000000000000000000
0000000000000000000000000000000
0000000000000000000000000000000
0000000000000000000000000000000
0000000000000000000000000000000
0000000000000000000000000000000
0000000000000000000000000000000
0000001111000000000000000000000
0000000000000000000000000000000
0001111000001110001000000000000
0000000000000000000000000000000
1111111111111111111111111111111
0000000000000000000000000000000
0000000000000000000000000000000
0000000000000000000000000000000

