00000000000000000000000000000000000000000000000000000000000000
00000000000000000000000000000000000000000000000000000000000000
00000000000000000000000000000000000000000000000000000000000000
00000000000000000000000000000000000000000000000000000000000000
00000000000000000000000000000100000000000000000000000000000000
00000000000000000000000000001000000000000000000000000000000000
00000000000000000000000000010000000000000000000000000000000000
00000000000000000000000000100000000000000000000000000000000000
00000000000000000000000001000000000000000000000000000000000000
00000000000000000000000010000000000000000000000000000000000000
00000000000000000000000100000000000000000000000000000000000000
00000000000000000000001000000000000000000000000000000000000000
00000000000000000000010000000000000000000000000000000000000000
00000011110000000000100000000000000001111000000000000000000000
00000000000000000001000000000000000001111000000000000000000000
00011110000011100010000000000000001111000001110001000000000000
00000000000000000000000000000000000000000000000000000000000000
11111111111111111111111000001111111111111111111111111111111111
00000000000000000000000000000000000000000000000000000000000000
00000000000000000000000000000000000000000000000000000000000000
00000000000000000000000000000000000000000000000000000000000000
00000000000000000000000000000000000000000000000000000000000000
00000000000000000000000000000000000000000000000000000000000000
00000000000000000000000000000000000000000000000000000000000000
00000000000000000000000000000000000000000000000000000000000000
00000000000000000000000000000000000000000000000000000000000000
00000000000000000000000000000000000000000000000000000000000000
00000000000000000000000000000000000000000000000000000000000000
00000000000000000000000000000000000000000000000000000000000000
00000000000000000000000000000000000000000000000000000000000000